1123333111
1        1
3   1    1
1        1
1112  2  1
1   1    1
1        2
1        1
1        2
1112222211