1123333111
1        1
3   1    1
1        4
1112  2  1
1   1    1
1        5
1        1
1        2
1112222211