1111111111
1   1    1
1   1    1
1        1
1111111  1
11511    1
1   1    1
1   1    1
1        1
1111111111