2222222222
2  2  2  2
2  2     2
2  2 2   2
2  2 2   2
2  2 2 2 2
2  2 2   2
2  2 22  2
2    22 22
2222222522